R 2200 1100
NO ./textures/woodenshape.png
S ./sprites/zombie.png
EA ./textures/redbricks.png
WE ./textures/oldbricks2.png
SO ./textures/ancient.png



F 116,116,116


C 0,0,0

            111111111
         1 10000000011
           10000020011
           1000000001
           1000000001
           1000000N01
        1110000000001
       10010000000021
      110010000100001
     1000000000000001
     110000000100001 
  11100000000001111  
 1000000000000001    
 1010000001000001    
1000011011100111     
 1111  1   11
