R 1400 700
NO ./textures/shiny.png
S ./sprites/sprite1.png
EA ./textures/greytiles.png
WE ./textures/greeny.png
SO ./textures/golden.png



F 116,116,116


C 255,178,121

                                           11     
                                          1001    
                                         10001    
                                        1000001   
                                        100101    
                                        1000001   
                                        1000001   
                                        1000001   
                                        1000001   
                                       10000001 1 
                                       10000000101
                                       10000100001
                              11        1011100001
                     111111111001       1020000001
                11  1000000000001       1000000001
            1  1001 1000000000001       1000000001
          11011100110000001100001       1011000001
         10020000000000000000000111     1000001001
         100011110000000002000000001    111100001 
         1001  110000000100000000001   10011000001
          11111000000000000000000001 111000000001 
           100000000000000000000000110000000000021
           101110000000000000000011100020100011001
           101101000000000000000011101000000000001
           10100000000000010000101000010000001111 
           1000100000000000000010100001100201     
            111 11000000000000000100000110001     
                 100001100000010100010011001      
                 10000000000000000001001 101      
                  11000000000001000000011001      
                    1011100001110000001 1001      
                  11100000000000001010111101      
                 10010200000W000001001000001      
         1111  11100000000000000000000000111      
        1000011000000000210200000000000000001     
        1000011001000001011000000011000000001     
 1     111011 10110011000010000000000000000001    
101111100001111000000000001100000000000000011     
10000000100000001001020001100000000200000001      
10000001 1100000111000000000000000000000001       
1000001    11001  1000010100002000000000001       
1000001      101   10000000000100000000001        
100001        1    10000010001100000000001        
 1011              10000000001100010100001        
  1               10000000111110000000111         
                  10000000000010000001            
                   100000011101000111             
                    1000001 100011                
                    100001   111                  
                   1000001                        
                    111101                        
                        1