R 1400 700
NO ./textures/metal.png
S ./sprites/knight.png
EA ./textures/bricks.png
WE ./textures/metalwall.png
SO ./textures/hardwall.png



F 116,116,116


C 118,78,12


         1111111111111111111111111
         1000000000110000000000001
         1011000001110000002000001
         1001020000000000000000001
111111111011000001110000000000001
100000000000000001110111111111111
11110111111111011100000010001
11110111111111011101010010001
11000000110101011100000010001
10002000000000001100000010001
10000000002000W01101010010001
1120000111010101111101111000111
11110111 1110101 101111010001
11111111 1111111 111111111111